_x___x_z__
_y___x_y__
_x_z___x__
_y___x_y__
_x___x_z__