_x_____z__
_y___x_y__
_x_z___x__
_y___x_y__
_x_z_x_z__